1.844888483209172481e-01
1.471917037675602724e-01
1.891645259752930686e-01
1.952010134337552744e-02
1.123286026456344205e-01
1.291147432035889553e-01
2.066902514258122867e-02
1.375093017502892478e-01
1.196645085715903056e-01
1.588881101322679734e-01
1.100696517746264647e-01
2.138430183701501563e-01
1.626200290317451613e-01
1.429877524119083088e-01
8.643361868115367885e-02
1.922823369425365747e-01
8.049594265412787775e-02
1.342500005997110391e-01
1.804234382480556301e-02
1.275413935992399384e-01
1.066039756178981113e-01
8.489274858663001244e-02
7.990982403068078166e-02
1.678862382195053793e-01
9.213369145856134534e-02
1.855399265467775061e-01
1.498258105114922134e-01
1.221588409781182716e-01
1.994344399108165591e-02
1.995105249524811719e-01
1.940253728048834184e-02
1.415376616079042082e-01
2.481860282101771426e-02
1.311357034133250332e-01
1.493424693459907693e-01
1.540672317499782173e-01
1.044462401599573487e-01
1.376396962766031073e-01
7.815653659884838622e-02
1.921596668901044414e-01
1.909966381703014360e-01
1.882772026281758285e-02
1.790120420343613017e-01
2.258533805731004901e-02
1.473235337325240479e-01
1.282130506481556076e-01
9.080808592518663236e-02
2.261382945040948389e-01
2.724229156411116931e-02
1.546861981077544967e-01
1.452815009074873154e-01
2.045128230480972725e-02
8.559633735749710981e-02
1.931085879860298601e-02
6.246814637614658827e-02
1.875077750879756977e-02
2.100993906787140542e-01
1.788714504221947665e-01
1.955883476734984749e-02
1.650328559971875053e-01
1.297991259977988865e-01
2.116107904588041683e-02
1.036330093008508424e-01
1.094814337292727008e-01
4.514324995281712716e-02
1.935865419460344738e-01
2.235465175743512473e-02
2.374135613694794769e-02
1.808530657996966218e-01
1.802920875702070658e-01
2.263941289100880605e-02
1.574398312442005232e-01
1.768258778074391357e-02
9.042412166427754583e-02
1.093060737709188601e-01
2.211862852642703103e-01
1.186198287834078768e-01
1.928796461478065605e-01
1.952853235091905892e-01
2.221358429515324362e-01
1.525373670349986499e-01
2.056537764362718901e-02
1.728995903663350098e-01
1.481426523700666853e-01
1.721156526493685113e-01
1.876207799800543863e-01
2.083609885721984106e-02
9.393621784581449030e-02
2.254166240695792620e-02
1.864607624842848366e-01
1.122563933955485899e-01
1.646907790167213281e-01
9.963825627589195655e-02
2.622122132460799615e-02
2.458515201189381133e-02
2.004853253501019117e-01
2.297745260080674007e-02
2.412728040777850982e-02
9.781413024346222174e-02
1.975354347968489022e-01
